---
Composes By: Koji Kondo
Arranged By: Stamen47
Style:
  - Arrangement
  - Fingerstyle
Series: Legend of Zelda
Game: A Link to the Past
Title: Dark World
---

      E   E   E   S S E   Q       E       E   E   E   S S E   Q       E
A5|-----------------------------------|-------1---1---1-1-1---3-----------|
E5|-------3---3---3-3-3---5-----------|-----------3-------3---5-----------|
C5|---0-------3-------3---5-------0---|---0---------------------------0---|
G5|-----------------------------------|-----------------------------------|

      E   E   E   S S E   Q       E       E   E   E   S S E   Q       E
A5|-----------------------------------|-------1---1---1-1-1---3-----------|
E5|-------3---3---3-3-3---5-----------|-----------3-------3---5-----------|
C5|---0-------3-------3---5-------0---|---0---------------------------0---|
G5|-----------------------------------|-----------------------------------|

      E   E   E   S S E   E   E   E       S S E   E   S S E   E   E   S S  
A5|-------------------------------3---|---0-1-0---L-----------------------|
E5|-----------------------------------|---1-------1---1-1-1---1---1-------|
C5|-------3---3---3-3-3---0-----------|-------------------------------7-5-|
G5|---0---------------L-------0-------|-----------------------------------|

      E   E   E   S S E   E   E   E       S S E   E   S S E   E   E   S S  
A5|-------6---------------------------|---1---------------------------3-1-|
E5|---------------4-4-4---4---4-------|-----------1---1-1-1---1---1-------|
C5|---7-------0-------------------5---|---2-3-2---L-----------------------|
G5|-------5---------------------------|-----------------------------------|

      E   E   E   S S E   Q       S S     E   E   E   S S E   Q       E    
A5|---3-----------------------------A-|---5-------------------------------|
E5|-------3---3---3-3-3---5-------8---|-------6---6---6-6-6---8-----------|
C5|---0-------3-------3---5-----------|---0-------7-------7---9-------0---|
G5|-----------------------------------|-----------------------------------|

      E   E   E   S S E   E   E   E       S S E   E   S S E   E   E   S S  
A5|-------------------------------3---|---0-1-0---L-----------------------|
E5|-----------------------------------|---1-------1---1-1-1---1---1-------|
C5|-------3---3---3-3-3---0-----------|-------------------------------7-5-|
G5|---0---------------L-------0-------|-----------------------------------|

      E   E   E   S S E   E   E   E       S S E   E   S S E   E   E   S S  
A5|-------6---------------------------|---1---------------------------3-1-|
E5|---------------4-4-4---4---4-------|-----------1---1-1-1---1---1-------|
C5|---7-------0-------------------5---|---2-3-2---L-----------------------|
G5|-------5---------------------------|-----------------------------------|

      E   E   E   S S E   E   S S S S     E   E   E   S S E   Q       S S  
A5|---3-----------------------8-6-5---|---5-------------------------------|
E5|-------3---3---3-3-3---5---------8-|-------6---6---6-6-6---8-------3-5-|
C5|---0-------3-------3---5-----------|---0-------7-------7---9-----------|
G5|-----------------------------------|-----------------------------------|

      E   E   E   S S E   E   E   E       S S E   E   S S E   E   E   S S  
A5|-------------------------------1---|---0-------------------------------|
E5|---6-------------------------------|-------1---L---------------------1-|
C5|---3-------3---3-3-3---3---3-------|-----------0---0-0-0---0---0---3---|
G5|-------0---0---------------0-------|-----0-----------------------------|

      E   E   E   S S E   E   E   E       S S E   E   S S E   E   E   S S  
A5|-------3---3---3-3-3---3---6-------|-----------5---5-5-5---1-----------|
E5|-------4---4---4-4-4---4---4-------|-----------------------1---1---3-5-|
C5|-------3---3---3-3-3---3---0-------|---5-3-2---L---------------2-------|
G5|---0---------------------------0---|-----------3-------3---------------|
  
      E   E   E   S S E   E   E   E       S S E   E   S S E   E   E   S S   
A5|-------------------------------1---|---0-1-3---L-----------------------|
E5|---6-------------------------------|---1-------1---1-1-1---1---1---1-1-|
C5|---3-------3---3-3-3---3---3-------|-----------------------------------|
G5|-------0---0---------------0-------|-----------2-------2-------2---2-2-|

      E   E   E   S S E   E   E   E       S S E   E   S S E   E   E   S S
A5|---1---------------------------1---|---0---0---L-----------------------|
E5|---0---0---0---0-0-0---0---0-------|---2-------2---2-2-2---2---2---2-2-|
C5|-----------------------------------|---2-------2---2-2-2---2---2---2-2-|
G5|---0-----------------------0-------|-----0-----------------------------|

      E   E   E   S S E   E   E   S S     E   E   E   S S E   E   E   S S 
A5|-------5---5---5-5-7---7-----------|-------8---8---8-8-7---7-----------|
E5|---3-------------------------------|-------A---A---A-A-8---8-----------|
C5|---2-------------------------------|-----------------------------------|
G5|-------3---3-------5---5---0---0-0-|---0-----------------------0---0-0-|

      S S S S E   Q       E   E   S S     S S S S E   Q       E   E   S S 
A5|---3-----------------------3-------|---1-------------------------------|
E5|---4---1-------4-------4---4---4-4-|---3---1-------3-------3---3---3-3-|
C5|---3-----------3-------3---3---3-3-|---2-----------2-------2---2---2-2-|
G5|-----0---0-l-----------------------|-----0---0-L-----------------------|

      S S S S E   Q       E   E   S S     S S S S E   Q       E   E   S S
A5|---1-----------4-------------------|---------------3-------------------|
E5|-----1---------2-------2---2---2-2-|---------------1-------------------|
C5|-------3-5-l-----------1---1---1-1-|-----3-2-3-l-----------0---0---0-0-|
G5|---------------3-----------3-------|---1-----------1-------1---1---1-1-|
 
      S S S S E   Q       E   E   S S     S S S S E   Q       E   E   S S
A5|---------------1-------------------|---3-----------------------3-------|
E5|---------------0-------0---0---0-0-|-------1---------------------------|
C5|-----2-1-2-l-----------------------|---3-----------3-------3---3---3-3-|
G5|---0-----------------------0-------|-----0---0-l-----------------------|

      Q.          Q       E   E   S S     Q.          Q       E   E   S S
A5|---5-------------------------------|---3-----------2-------2---2---2-2-|
E5|---2-----------2-------2---2---2-2-|---3-----------3-------3---3---3-3-|
C5|---2-----------2-------2---2---2-2-|---2-----------2-------2---2---2-2-|
G5|---2-----------2-------2---2---2-2-|---0-----------0-------0---0---0-0-|

      E   E   E   S S E   Q       E      
A5|---3-------------------------------|
E5|-------3---3---3-3-3---5-----------|
C5|---0-------3-------3---5-------0---|
G5|-----------------------------------|